.....wS.......ww
vwww...ww.<w..wv
www^Sv.wwwwww...
.www.....www....
..w.....ww......
.www..^Sv...w.w.
.w........w^Sww.
....ww...w<www>.
...wwww<...wwww.
..S^w.........w.
.>www..S....w...
.ww....w^..www<S
..<...www...wwww
.wSw..wwS....w<w
.www.wwww>...w..
F.w..<w........T
