 w W W . . ..S... . .. . .
 w v W S[M/..v.Ww v .. .[\M
 . . . . . ..w... . .. w w
 .[M/. . > ...... . .. < w
 > . . . . W..... . .v . .
 . . . . . SS.SS. . S. W W
 W < W W W S...W< . .. . .
 ^ . ^ . ^ S.M.WS S SS W .
 . . . ^ . WMTM.. . .. . <
 . . . . . S.M.WS S S. . .
 . . . . . <SwWS. . .. S .
 . > . . . .S.... . .^ w .
 . . . . . ...... S Sw S .
[M\. .[\M^ SSSS.w . Sw S W
 . . . . . ....ww < Sw S w
 S . ^[/M. ..SwwF[M\..[/Mw
