 S SvWw v S S S .. S >  . . S
 S W..W w . . . .. . .  . M[\S
 . .... W S > . .. . .  . .[/S
 . ..W. . W S[M\.M . .  . . S
 > M..W[/SS . w .. S[S\[/S. .
 W ..^w S S w S SS S S  S S .
 W WWWS[S/w[\Mw .. . .  . M w
 S wwSS w w w S SS S S  S S .
 W wwWS[S\w . w .. . .  . S F
[M/.... S S w M SS[S\.  . < S
 . ..M. . . . w .. S .  . . .
 M .... < S ^[M/..[\M.  . . v  
 w .... . < S . .W .[\M . . .
 w ..M. . < S . .w[M\.  . . .
 w M... . S > . .w w W  . M .
 . .... S S . . T. . .  . .[/S
