ww w wwww.. . .....F
.. . .....v w wwwwww
.S > ....<. . ......
.S . ...... . >...v.
.S > ...<.. . ......
.. . ...... . ..M...
>. . ...<.. . ......
.. . ...... . ......
.. S SS..S. . ......
S. . ..S..^ . ......
>w w wwwM.W . ......
.. . ..^..S[/M^.....
.v . S.S>ww . ..^...
.. . S..... . ..M...
.. . WW.... . ....<.
T^[/M...... . ......
