eeSSSSeee
eeST.SSSe
SSS.M..Se
SFSS.S.SS
SwSS.S..S
Sw.M..S.S
Sw....M.S
SSSSSSSSS
