SSSSSSSSS S SS S SSS
SF.v....S S SS S SSS
S..W.M..S S SS S SSS
S>WW....S S SS S SSS
S.......S S SS S SSS
S........ . WW W W.S
S.......S . SS S S.S
S........[/MSS S S.S
S........ . .. . ..S
S........ . .. . ..S
S........ . SS S .^S
S........ . SS S SSS
S........ . SS S SSS
S........ . ..[T<..S
SM....... . .. . ..S
SSSSSSSSS S SS S SSS
