[S/ S vS[\SWSWWM S W[\M[\MM S
 . [M/.W W WWWWW M W W  W W[\S
 .  W .W S WWSWW S W W  S W W
 .  W .W W WWWWW W W W  W W W
 .  W .W W WWvWW W W v  W W W
 .  W .W W W^wS^[\MW W [\M. W
[M/ W .W S wwWFw < W W  W M W
[M/ W .W W <SWwS v ^ W  v S W
 M  W .S W WWwWW . W W  . > W
 S  W .> . ..... . . .  . W W
 M  W .W S W.S.S . . S  S S W
 . [M\.W W W.... . . .  . . W
 .  W .W S S>... . . .  . . W
 S  W .W W WW.SW W W W  W S W
 S  M .W W WWTWS W S S  W S W
 S [S\WW S MWWWW W W W  W M[/S
