wMwM w  M wM w  MwMwMw .
MSSS S  S SS S  SSSSww .
wSSS S  S SS S  SSSS.M .
MSSS S  S SS S  SSSSww w
wSSS S  S SS S  SSSSMS S
MSSS S  S SS S  SSSSw.[\S
wSSS S [S/ww w  wwwwMw .
MSSS S [S\ww .  wMwMwM[/S
wSSS S  S SS .  SSSSSS S
MSSS S  S Sw M  wwwwww[\S
wSSS S  F SS w  SSSSSS .
MSSS[S/ w Mw M  wwwwww[/S
wSSS[S\ w ww[/S SSSSSS S
MSSS S  S SS S  SSSSSS S
.SSS S  S SS S  SSSSSS S
.wMw M  w Mw M  wMwMwM T
