wwSSSSwww
wwST.SSSw
SSS.M..Sw
SFSS.S.SS
SwSS.S..S
Sw.M..S.S
Sw....M.S
SSSSSSSSS
