SSSSSeeSSSSS
S..SSSSS..TS
Swwww...MM.S
SwSSSS.S.M.S
SwSSSS.S.M.S
SwSS.M.SM..S
SwSS..MS.M.S
SwSS.M..M..S
SwFS..SS...S
SSSSSSSSSSSS
