 S W W W W W[M/.[\Mw . .... .
[S/. . .[\MW S S . w . S.<S v
[S\M . . . W S . . w . ...w .
 S w w w . W S . . w . >..w .
 S S S w w W S . . w < S.Sw W
 v v S . . W S . . w . ...w .
 . . . . . W S . . w . >..w .
 . . . . . . S . . w < S.Sw W
 . S . . . . w . . w . ...w .
 . .[M\. . . S . . w . >..w .
 S S S M . . < . . w w S.Sw W
 > . . . . . M . . . . ...w .
 S . . . . . . . . . . ...w .
 w W w W w W w W w .[/M..Sw w
 S . S T S . S . S . S .Sww .
 w > w . F . w . w[M\M www.[/S
