... . . ..[S/[\S.. . . ...
.SS M S M. w  w .M S . SM.
..M . S .M[S|[S|MM . . M..
..S . M M.[S|[S|w. . . MMS
.MS . S ..[S|[S|.M S M S..
... . M .S W  W S. . . MM.
..S S S .M W  W M. S . Sw.
.S. . . .S[S|[S|S. . . Mw.
... S S SS W  W SS S S .w.
T.S w w wS W  W Sw w w S..
Sww w w ww w  w ww w w wwS
Www w w SS w  w SS w w wwW
Www w w SW w  w WS w w wwW
Www w w SW w  w WS w w wwW
www w[M/SW .  F WS[\Mw www
www[M/. .S[S\[/SS. .[\Mwww
