[S/ . .vw W M .SFwwww..
[S\ . .M> w[/M.SSSvSSM.
[S/ . ..S[M\. .S....S..
[S\[\S.^w W < .S.M....S
[S/[/S.M> w[/M.S.M.....
[S\[\S..S v[M\.S.M...S.
[S/[/S.^w W < .S.....S.
[S\ . .M> w[/M.S.....S.
 .  w ..S v[M\.S.......
 .  . .^w W < .SSSSSSwS
 .  w MM> w[/M.S...S.M.
 .  w M.S v[M\.S.M..ww.
 .  . .^w W < ..SM.SSSS
 .  w MM> w[/M..S......
 .  w M.S v[M\..SSSSSS.
 .  . .^w W < Twwwwwwww
