....ww.. . ......<
....ww.. . ......<
..T.www.[\M.......
..M.wwww . .......
.M..ww.w w wwwwwww
...www.. . ......w
...www.. . .......
wwwwwwww . ...F...
wwwwwwww w w......
....wwww w ww.....
.....www w ww.....
........ w w......
........ . .......
.......S ^ S......
^......< S >......
