S  [S/ .  . ww.....w.M.F
S   .  S  S SSSSSSMSSMWW
S   .  S  . ....w<....SS
S   .  S  . SSSMSSSSS...
S   .  S  . S.......SwS.
S   .  .  . .w......w.Mw
[S/[S-[S-[\SSSMSSSSSS.S.
.   .  .  . ...wv..S..S.
[S| S  S  . ..........S.
[S| .  S [S|Sw^SSSSS..S.
[S| .  S  . S.........S.
.   .  M  . SSMSSSSS..S.
S   .  S  . ..........S.
S   .  S  w SSSSSSSSSSS.
S   .  .  . ............
S   S  S  S SWWTWSSSSSSS
