S . .... S  S S SSS S S S S
w > ....[S/[\S. .vS v . . S
w w >... .  . . ..v . . . S
. w ww.. .  . . ... . . .[\S
. w ww.. .  M . ... . . .[\S
. . www. .  . . ... . . . .
v . Swww .  . . ..M . . .[/S
. F .www W  W W ... M . < S
. . S.ww w  . . ...[/SS S S
W S SSSS w  w v SSS S S S S
S . .W.. w  w . <.. . .[\SS
.[T>.W.. .  w w ww. M . v[\S
. . SWS. .. . w w w .  M. .
. W WMWW WW W W w w w  w. .
^ . SWS. .. . W . . w  ww w
S > .... ..[/MW . . .  w. .
