. . . . .. S vvS......
. w M[M/.w[\Mww.w..Mw.
. M w . w.[M/ww..w.wM.
. . . w .. . ww...w...
w[M/w . wM . ...Mw.w..
> w . . Mw . ...wM..w<
S . . . .. w ..w.....S
w w w . M. . ww..M.www
w w w . M. . ww..MTwww
S . . . .. w ..w.....S
> w . . Mw . ww.wM..w<
.[M\w . wM . ww.Mw.wSS
. . . w .. . ww..wwSFw
. M w[M\w. . ww.SwwSww
. w M[M\.w . ...Swwwww
. . . . .. S ^^SSwww..
