e e SSS
S S STS S S
S W WWW W S
S[S\MwW[\SS
S[S/WwM[/SS
S[S\MwW[\SS
S[S/WwM[/SS
S[S\MwW[\SS
S S WwM[/SS
S S SFS S S
e e SSS
