eeS S SSeee
eeS[T>.SSSe
SSS . M..Se
SFS S .S.SS
SwS S .S..S
Sw. M ..S.S
Sw. . ..M.S
SSS S SSSSS
