SSSSSSSSSSSSSSSS
SSSSSSSSSS.....S
S..SSS...S..F..S
S.M....M.S.....S
S..SSSS.SSSSSS.S
SS.S....SwwwwwwS
SS.S..M.SwwSSSSS
SS.S.M.MSwwwww.S
SS.S..M.Sww..wwS
SS.S.M.MSSSS.wSS
SS.S..M.S..SSMSS
SS.S....S.MM.M.S
SS.SMSSSS......S
S.M...M.M.M.SSSS
S...S......SSSSS
SSSSSSSTSSSSSSSS
