......WSFSW.....
......<www>.....
.......wSw.....<
>...............
S.SSSSSSSSSSSS.S
S......<.>.....S
S>............<S
S.wwwwwwwwwwww.S
SWWWWWWWWWWWWWWS
>.......S......<
S.......S......S
SSSSS^^^S^^^SSSS
SSSS....M.M..SSS
SSSS.........SSS
SSSS^^^^^^^^^SSS
........T.......
