.>...........S..
v.......S....<.F
...S...<.....W..
...>.........<SS
S.S.....S.M.S...
.....S.S........
www>ww...S......
w>wwww...S.S....
wwwwwwS.M.M.....
wwwwwwS..M......
wwwwwwS..SS.....
wwwwwwwSMS......
..S...S.........
>...S...S.......
>.....S.........
......ST^^^^^...
