[S/w w w[\Mwwww w w M w M[\M[\S
 w w w w w SSFv S w .[\Mw w  w
 w w w w > Wwvw W < . . w w  w
 w w w w w SwWw S w[/M. w w  w
 w w w w w Swww S w w w w w  w
 w w w w w Sw.w S w w w w w  w
 w[M/.[M/. Ww.w W . . . .[/M w
 w . w w w ww.w w w w w w[\M w
 w . w w M Sw.w S M w w w .  w
 w . w w . Mw.w[M\w w M w[\M w
 w[M\w w w ww.w w w M w w .  w
 w . w w w Sw.w S w w M w .  w
 w . .[M\. Ww.w W[M\. . . .  w
 w[M\w w w ww.w w w w w w[/M w
 w w w w w Sw.w S w w w w w  w
[S\w w w w WwTw W w w w[M\w [/S
