.. . .ww.. . ......<
.. . .ww.. . ......<
..[Tv.www.[\M.......
.. M .wwww . .......
.M . .ww.w w wwwwwww
.. . www.. . ......w
.. . www.. . .......
ww w wwwww . ...F...
ww w wwwww w w......
.. . .wwww w ww.....
.. . ..www w ww.....
.. . ..... w w......
.. . ..... . .......
.. . ....S ^ S......
^. . ....< S >......
