[S/wwwwwwwww w wwww[\S
 w SSSwSSSSS S SSSS w
[M/SF.w.SSSS S SSSS w
 . wwww.WW.. . <SSS w
 . S....SSSS . SSSS w
 . SSWSSSSSS . SSSS w
 . SSWSSSSSS . SSSS w
 . ..WWWW... . <SSS w
 . SS..SS.SS S SSSS w
 . SSSSSS.SS S SSSS w
 . ...>....S S SSSS w
 w SSSSSS.SS S SSSS w
 w SSS>...M.[\SSSSS w
 w SSSSSS.SS w SSSS w
 w SSSSSS.SS w SSSS w
[S\wwww...T. . wwww[/S
