>.WWWWWvMvW>.vMv
W.W>......ww..w.
W.WW.WWW^..WW...
W....M>.MW....<.
W.<WWMMFvWWWW.M^
W....M>.w......M
W.<M.WWW.WWWWW.M
W.Mv.<M..W>....<
W....Mv.WWWWW.WW
WWM>........W...
.WvWWW.WWW^.W.W.
....<W....M.W.W.
^W.WWWWW>.v.W.W.
WW.M........W.W.
....TWWWWWWWW.W.
^M>...........W^
