 S S S S S S[S/F[ \SS S S S S S S
 S S S S S[S/M w  M[\SS S S S S S
 S S S S[S/w w w  w M[\SS S S S S
 S S S[S/w M w w  w w w[\SS S S S
 S S[S/w w w w M  . . w w[\SS S S
 S[S/w w w M w w  w w w M w[\SS S
[S/w w w w . w M  w M w w M w[\SS
 T w M . w . w M  w w w w w w M[\S
[S\w w . w w w w  w . M w w M w[/S
 S[S\w M w w M w  w . w w M .[/SS
 S S[S\w w w w M  w w M w w[/SS S
 S S S[S\w w M w  w w w w[/SS S S
 S S S S[S\w M w  w M w[/SS S S S
 S S S S S[S\w M  w .[/SS S S S S
 S S S S S S[S\w  w[/SS S S S S S
 S S S S S S S[S\[/SS S S S S S S
