SSSSSSSSS S SSSSSS
SF.v....S S SSSSSS
S..W.M..S S SSSSSS
S>WW....S S SSSSSS
S.......S S SSSSSS
S........ . WWWW.S
S.......S . SSSS.S
S........[/MSSSS.S
S........ . .....S
S........ . .....S
S........ . SSS.^S
S........ . SSSSSS
S........ . SSSSSS
S........ . .T...S
SM....... . .....S
SSSSSSSSS S SSSSSS
