 w[M/.[\Mw  W W W WWWW W W W[\S
 w w w w w  . w w wwww w w . w
 v . . M w  . w . ....[M/w w w
 . w w w w  w w[M/.... M w . w
 . w w w w  . M[M\...M w w w w
 W M . M w [\MW M wwwS M . . .
 w w w w w  w W M w.ww . . . .
 w w M M w  w[\MW wM..[M\.[/M.
 w w w w w  w w w wwMW . . . .
 w w M W W  w w w wwwW . . . .
 W W W[M/W  W w w wwwW . .[\M.
 > . . W[M/[\M. w wwwM . . . .
 S M w[/Mw  W w[\MW wwM. . . .
[S/w[M/w[/M w W W W wwww . . .
 . . . . S [M\w W[\Mwwww .[/M.
 T .[/Mw F  W w W[M\wwww . .[/S
