FWWWWWvWWvWvWWW<
WWWW>WWWvWWWWWWW
WW>WWW<WWWW<>vWW
WWWWvWWWWWWWWWWW
WWWWWWWWWW^WWWWv
>WWWWvvWWWv>WWvW
W>WWWWWW>WWWWW<W
WW>W>WWvvWWWvWvW
WWW>WWWWWW>vWWWW
WWWWW>WWWvWWWWWW
WvW^WvWWvW^WWvWW
WWWWWWWWWWWWWWWW
WWvWvW>WWWWWvWWW
WWWWWWWW>WWWWWW<
>WWW>WWWWWW>WWWW
WW^WWW^W^WWW^>WT

