eeeeeSSSSSSS
SSSSSS..SFwS
S....MM.SSwS
S.SM..M.SSwS
S.S..SM.SSwS
S...SS..SSwS
SSSM.S.SSSwS
SSS...M.wwwS
S...M.MTS..S
S.S.SSSSSSSS
S...Seeeeeee
SSSSSeeeeeee
