S[S/..ww.....w.M.F
S . SSSSSSSSMSSMWW
S . S.....w<....SS
S . S.SSSMSSSSS...
S . S.S.......SwS.
S . ...w......w.Mw
S S SSSSMSSSSSS.S.
. . .....wv..S..S.
S S S...........S.
S . SSSw^SSSSS..S.
S . S.S.........S.
S . M.SSMSSSSS..S.
S . S...........S.
S . SwSSSSSSSSSSS.
S . ..............
S S SSSWWTWSSSSSSS
