[S/. W . w w .Swv . w w . M[\S
[S\. S M . . Sv>. . w w . S .
 S . S . . w wwF. w w . . S .
 v . W . . . .www w . . W v .
 w . S W . . .... . . W . . .
 w M S S W . .ww. . . .[/M. .
 w . S . S W .Www S S S S . .
 . . W . . . .WWW W . . W . .
 .[\MS . . . S... W . . W w .
 . w S > w w wwww w w w w w .
 . w S[S/. . ..WW W . W W . .
 . w S[S\.[M/..W. . . . W . .
 . . w . . . .... . S . . . .
[M\S w . . . .^.. . . S . .[/M
 w S ^ M . . <W>. . M[\SS . .
 W W W . w ^ WWW^[M\.[/SS S T
