e e S S S
S S S[TvS S S
S W W W W W S
S[S\M w W[\SS
S[S/W w M[/SS
S[S\M w W[\SS
S[S/W w M[/SS
S[S\M w W[\SS
S S W w M[/SS
S S S F S S S
e e S S S
