[S/w. .  . w ww w w.. .  . w[\S
 w .M[M/ . . ww w w.M .  . w w
 . ww w  w w .w[\Mw.M[M/[\M. .
 . ww w  w w .w . w.. .  w . .
 . ww >  w w ww M ww. .  . M .
 . ww w  w w ww . wM. .  . . .
 . ww M  w w w. . ..< .  . M .
 . w. w  . w ww . wM. .  . . .
 . w. w  . w ww M ww> w  . M .
 . w. w  . w ww . wM. .  . . .
 . w. w  w w ww . ww. .  . . .
 . Mw w  M . ww . w.< .  . . .
 . .w w  . . Sw M www w  . . .
 . ww[M\[/M^ Sw . ... w  < . .
[M\ww w  w[/M.w w w.. w [/M. .
[S\ww w  w w Fw T w.. w  . .[/S
